figma 단축키

보기	Windows	Mac
메뉴 숨기기/보기	Ctrl + \	Cmd + \
안내선 보기/숨기기	Shift + R	Shift + R
기본 툴	Windows	Mac
선택/이동하기	V	V
텍스트	T	T
원	O	O
사각형	R	R
프레임	F	F
선택/그룹	Windows	Mac
여러 요소 선택	Shift + 클릭	Shift + 클릭
색 선택 (아이드로퍼)	I	I
그룹/프레임 내 요소 선택	Ctrl + 클릭	Cmd + 클릭
전체 선택	Ctrl + A	Cmd + A
그룹	Ctrl + G	Cmd + G
그룹 해제	Shift + Ctrl + G	Shift + Cmd + G
프레임으로 만들기	Alt + Ctrl + G	Option + Cmd + G
커서	Windows	Mac
요소 간격 확인하기	Alt + 호버	Option + 호버
요소 복제하기	Alt + 드래그	Option + 드래그
중간을 기준으로 크기 바꾸기	Alt + 크기 변경	Option + 크기 변경
비율에 맞게 크기 바꾸기	Shift + 크기 변경	Shift + 크기 변경
이동	Windows	Mac
캔버스 내에서 이동하기	Space + 드래그	Space + 드래그
캔버스 확대하기	+	+
캔버스 축소하기	-	-
배치	Windows	Mac
뒤로/앞으로 보내기	Ctrl + [ , Ctrl + ]	Cmd + [ , Cmd + ]
맨 뒤로/맨 앞으로 보내기	[ , ]	[ , ]
위쪽/아래쪽으로 정렬	Alt + W , Alt + S	Option + W , Option + S
왼쪽/오른쪽으로 정렬	Alt + A , Alt + D	Option + A , Option + D
수평 중앙 정렬	Alt + H	Option + H
수직 중앙 정렬	Alt + V	Option + V
편집	Windows	Mac
복사하기	Ctrl + C	Cmd + C
오려두기	Ctrl + X	Cmd + X
붙여넣기	Ctrl + V	Cmd + V
복사+붙여넣기	Ctrl + D	Cmd + D
이름 변경	Ctrl + R	Cmd + R
속성 복사하기	Alt + Ctrl + C	Option + Cmd + C
속성 붙여넣기	Alt + Ctrl + V	Option + Cmd + V
고급 기능	Windows	Mac
오토 레이아웃 추가하기	Shift + A	Shift + A
컴포넌트로 만들기	Alt + Ctrl + K	Option + Cmd + K
이 외에도 많은 단축키들이 있는데요, 어떻게 확인할 수 있을까요? Figma 화면 우측 하단에 ?를 클릭하면 나오는 목록에서 Keyboard shortcuts를 누르면 됩니다.

bold 31pt #1d1d1d   notosanskr 10pt regular #542Acc